FRS = "countries/Froscburgen.txt"
EDW = "countries/Edwinar.txt"
MLS = "countries/Maelstone.txt"
ESM = "countries/Estmere.txt"
SMA = "countries/Smaradis.txt"
ELY = "countries/Elyaesia.txt"
DMR = "countries/Dammerung.txt"
OGL = "countries/Ogland.txt"
SCT = "countries/Scotar.txt"
MRL = "countries/Morland.txt"
NOZ = "countries/New Ozarkhia.txt"
HSH = "countries/Hesh.txt"
GLL = "countries/Gaeliland.txt"
ZAH = "countries/Zahart'alavaar.txt"
HFH = "countries/Haifha.txt"
QUA = "countries/Quarfa.txt"
LYS = "countries/Lyssiosia.txt"
KNK = "countries/Konk.txt"
SLB = "countries/Slabhra.txt"
ESS = "countries/Essonnia.txt"
CHT = "countries/Chahtzoacl.txt"
JIN = "countries/Jinshu.txt"
JUZ = "countries/Juzur.txt"
NSP = "countries/New Spol.txt"
LAS = "countries/Lasturia.txt"
CNC = "countries/Na Crun.txt"
ALS = "countries/Al'Asad.txt"
SLC = "countries/Solchutia.txt"
DYO = "countries/Dyopolniki.txt"
TNU = "countries/Tunnu.txt"
OMC = "countries/Oben-Melcani.txt"
ENE = "countries/Enezenn.txt"
EIL = "countries/Eilea.txt"
MLK = "countries/Melkhia.txt"
FRF = "countries/Fort Federation.txt"
OZA = "countries/Ozarkhia.txt"
GNG = "countries/Gangir.txt"
CRB = "countries/Crabalonia.txt"
ZAD = "countries/Zadouar.txt"
KRN = "countries/Kornand.txt"
SRB = "countries/Serobikha.txt"
OBN = "countries/Obensino.txt"
RIV = "countries/River Republic.txt"
VAL = "countries/Valis.txt"
VRD = "countries/Verden.txt"
OCL = "countries/Ocelidia.txt"
ARL = "countries/Aroluenne.txt"
ADN = "countries/Adnuin.txt"
HLV = "countries/Helvuria.txt"
TMS = "countries/Tampasea.txt"
ERE = "countries/Erebor.txt"
AER = "countries/Aeruth.txt"
BRK = "countries/Brak Keriou.txt"
MAA = "countries/Ma'afi.txt"
STR = "countries/Sternhell.txt"
FCE = "countries/Eldai.txt"
ZUN = "countries/Zuntlan.txt"
SUV = "countries/Suviena.txt"
HEV = "countries/Hevosen.txt"
TEN = "countries/Tensali.txt"
KHA = "countries/Kharakhorum.txt"
MER = "countries/Merden.txt"
KAA = "countries/Kaaldari.txt"
ASA = "countries/Aussa.txt"
GRK = "countries/Grokkedaria.txt"
VES = "countries/Vestrosia.txt"
SCC = "countries/South Cradle.txt"
CNT = "countries/Centmasion.txt"
NBR = "countries/North Brahgua.txt"
SBR = "countries/South Brahgua.txt"
STP = "countries/Stepamad.txt"
PRZ = "countries/Przilohana.txt"
ERS = "countries/Eresacta.txt"
YYD = "countries/Ddraig.txt"
AUR = "countries/Auroliland.txt"
BOG = "countries/Bogg.txt"
PYA = "countries/Pyaltsev.txt"
PLA = "countries/Platoix.txt"
CAR = "countries/Carolais.txt"
SUS = "countries/Susans.txt"
MNG = "countries/Manegeria.txt"
KAN = "countries/Kanesema.txt"
SHO = "countries/Shokan.txt"
BYT = "countries/Bythonia.txt"
BRS = "countries/Bytos Reserve.txt"
SHS = "countries/Shin Shokan.txt"
ALZ = "countries/Alzha.txt"
ZAT = "countries/Zatoka.txt"
MDR = "countries/Madraxx.txt"
KYT = "countries/Kythia.txt"
JOD = "countries/Jodokage.txt"
ASH = "countries/Ashkanabi.txt"
QAY = "countries/Qayabr.txt"
SAH = "countries/Sahab.txt"
BOS = "countries/Bosem.txt"
KID = "countries/Kido.txt"
KDM = "countries/Kido March.txt"
BMK = "countries/Kido Bosem.txt"
FCC = "countries/New Chauntea.txt"
MYC = "countries/Mycena.txt"
OPI = "countries/Opito.txt"
OOI = "countries/Omain Opito Inferio.txt"
ODA = "countries/Otio o Dahe.txt"
HLG = "countries/Helghast.txt"
KRL = "countries/Kurland.txt"
KAR = "countries/Karpunia.txt"
XUA = "countries/Xuaze.txt"
DAH = "countries/Dahe.txt"
MRH = "countries/Morhogg.txt"
MRZ = "countries/Morze.txt"
SIE = "countries/Sieraldhia.txt"
UNG = "countries/Ungla.txt"
ANQ = "countries/Hadwadate.txt"
ATS = "countries/Altansarnai.txt"
USP = "countries/Union of Sinniate Patrixist Republics.txt"